S,,,#,,,,,,#
,#,,,#,,#,,#,
,#,,,#,,#,,#,
,#,,,#,,#,,#,
,,,,,,,,#,
,#,,#,,#,,#,,
,#,,#,,#,,#,,
,#,,#,,#,,#,,
,#,,#,,,,,,
,#,,#,,#,,,E,