S, ,#, , ,#,E
, ,#, , ,#,
, ,#, , ,#,
, , , , , ,
,#, ,#, ,#,
,#, , , ,#,
,#, ,#, , ,