S, , ,#, , , , , ,#
,#, , ,#, ,#, ,#,
,#, , ,#, ,#, ,#,
,#, , ,#, ,#, ,#,
, , , , , , , ,#,
,#, ,#, ,#, ,#,,
,#, ,#, ,#, ,#,,
,#, ,#, ,#, ,#,,
,#, ,#, , , , , ,
,#, ,#, ,#, , ,E,